UniqueID,Tray,Genotype,GrandmaternalTemp,GrandmaternalVern,MaxLeafNumber,MaxLength,Bolting,Flower,FirstFruit,FirstYellowFruit,Generation,FlowerInterval,FruitInterval
Ag0_1,A,Ag0,High,Vernalized,24,27.63,30,35,39,54,Progeny,5,19
Ag0_10,J,Ag0,High,Vernalized,15,22.68,24,30,33,51,Progeny,6,21
Ag0_11,K,Ag0,High,Vernalized,24,26.44,34,40,43,57,Progeny,6,17
Ag0_12,L,Ag0,High,Vernalized,11,15.77,26,36,38,53,Progeny,10,17
Ag0_13,A,Ag0,High,Unvernalized,19,29.24,29,34,37,55,Progeny,5,21
Ag0_14,B,Ag0,High,Unvernalized,28,30.6,31,40,44,57,Progeny,9,17
Ag0_15,C,Ag0,High,Unvernalized,16,25.95,26,34,36,54,Progeny,8,20
Ag0_16,D,Ag0,High,Unvernalized,16,22.72,26,33,35,54,Progeny,7,21
Ag0_17,E,Ag0,High,Unvernalized,16,24.78,26,35,37,52,Progeny,9,17
Ag0_18,F,Ag0,High,Unvernalized,16,28.8,26,34,35,53,Progeny,8,19
Ag0_19,G,Ag0,High,Unvernalized,16,22.87,30,36,38,53,Progeny,6,17
Ag0_2,B,Ag0,High,Vernalized,16,21.25,25,34,41,60,Progeny,9,26
Ag0_20,H,Ag0,High,Unvernalized,24,25.77,28,34,36,60,Progeny,6,26
Ag0_21,I,Ag0,High,Unvernalized,14,22.98,26,33,37,52,Progeny,7,19
Ag0_22,J,Ag0,High,Unvernalized,26,29.96,29,35,36,57,Progeny,6,22
Ag0_23,K,Ag0,High,Unvernalized,16,25.51,26,35,38,53,Progeny,9,18
Ag0_24,L,Ag0,High,Unvernalized,14,21.76,26,34,36,54,Progeny,8,20
Ag0_26,B,Ag0,Low,Vernalized,22,29.71,28,36,40,46,Progeny,8,10
Ag0_28,D,Ag0,Low,Vernalized,20,23.86,30,39,41,58,Progeny,9,19
Ag0_29,E,Ag0,Low,Vernalized,21,23.46,30,36,39,54,Progeny,6,18
Ag0_3,C,Ag0,High,Vernalized,24,26,30,38,40,57,Progeny,8,19
Ag0_31,G,Ag0,Low,Vernalized,16,23.2,26,37,40,53,Progeny,11,16
Ag0_32,H,Ag0,Low,Vernalized,20,29.57,30,38,40,55,Progeny,8,17
Ag0_33,I,Ag0,Low,Vernalized,28,33.49,32,40,44,46,Progeny,8,6
Ag0_34,J,Ag0,Low,Vernalized,23,32.34,33,42,44,56,Progeny,9,14
Ag0_35,K,Ag0,Low,Vernalized,38,36.24,28,34,38,51,Progeny,6,17
Ag0_36,L,Ag0,Low,Vernalized,19,33.58,28,39,41,57,Progeny,11,18
Ag0_37,A,Ag0,Low,Unvernalized,15,30.71,23,29,32,51,Progeny,6,22
Ag0_38,B,Ag0,Low,Unvernalized,14,16,32,39,42,57,Progeny,7,18
Ag0_39,C,Ag0,Low,Unvernalized,16,28.11,26,39,43,58,Progeny,13,19
Ag0_4,D,Ag0,High,Vernalized,15,22.26,26,34,37,54,Progeny,8,20
Ag0_41,E,Ag0,Low,Unvernalized,16,23.58,26,35,39,54,Progeny,9,19
Ag0_42,F,Ag0,Low,Unvernalized,22,34.81,39,46,49,63,Progeny,7,17
Ag0_43,G,Ag0,Low,Unvernalized,22,29.69,34,43,45,59,Progeny,9,16
Ag0_44,H,Ag0,Low,Unvernalized,24,27.86,34,43,47,55,Progeny,9,12
Ag0_45,I,Ag0,Low,Unvernalized,21,25.18,30,34,37,51,Progeny,4,17
Ag0_46,J,Ag0,Low,Unvernalized,16,25.96,26,35,38,52,Progeny,9,17
Ag0_47,K,Ag0,Low,Unvernalized,15,20.26,26,38,43,56,Progeny,12,18
Ag0_48,L,Ag0,Low,Unvernalized,28,39.17,37,44,46,60,Progeny,7,16
Ag0_5,E,Ag0,High,Vernalized,13,22.28,26,37,38,59,Progeny,11,22
Ag0_6,F,Ag0,High,Vernalized,15,21.77,32,40,42,61,Progeny,8,21
Ag0_7,G,Ag0,High,Vernalized,18,16.3,31,40,43,58,Progeny,9,18
Ag0_8,H,Ag0,High,Vernalized,16,29.86,26,34,37,52,Progeny,8,18
Ag0_9,I,Ag0,High,Vernalized,20,28.82,26,35,39,54,Progeny,9,19
Col0_1,A,Col0,High,Vernalized,31,34.33,32,41,47,61,Progeny,9,20
Col0_10,J,Col0,High,Vernalized,25,21.17,29,38,40,60,Progeny,9,22
Col0_12,L,Col0,High,Vernalized,29,29.8,34,40,47,62,Progeny,6,22
Col0_13,A,Col0,High,Unvernalized,26,34.93,39,46,49,63,Progeny,7,17
Col0_14,B,Col0,High,Unvernalized,26,23.32,36,45,47,64,Progeny,9,19
Col0_15,C,Col0,High,Unvernalized,25,23.83,34,40,45,60,Progeny,6,20
Col0_16,D,Col0,High,Unvernalized,30,20.92,40,50,54,69,Progeny,10,19
Col0_17,E,Col0,High,Unvernalized,31,24.36,32,39,43,59,Progeny,7,20
Col0_18,F,Col0,High,Unvernalized,24,27.98,41,52,54,69,Progeny,11,17
Col0_19,G,Col0,High,Unvernalized,23,28.05,34,43,45,60,Progeny,9,17
Col0_2,B,Col0,High,Vernalized,26,24.15,32,40,42,60,Progeny,8,20
Col0_21,I,Col0,High,Unvernalized,23,19.99,36,42,45,59,Progeny,6,17
Col0_22,J,Col0,High,Unvernalized,23,20.66,34,40,43,60,Progeny,6,20
Col0_23,K,Col0,High,Unvernalized,25,22.86,30,36,39,53,Progeny,6,17
Col0_24,L,Col0,High,Unvernalized,28,28.83,33,40,47,61,Progeny,7,21
Col0_25,A,Col0,Low,Vernalized,28,35.32,32,41,43,51,Progeny,9,10
Col0_26,B,Col0,Low,Vernalized,21,28.59,30,42,44,58,Progeny,12,16
Col0_27,C,Col0,Low,Vernalized,23,24.95,34,42,45,62,Progeny,8,20
Col0_29,E,Col0,Low,Vernalized,28,31.91,32,41,45,60,Progeny,9,19
Col0_3,C,Col0,High,Vernalized,24,29.69,26,41,47,60,Progeny,15,19
Col0_30,F,Col0,Low,Vernalized,22,31.42,30,41,43,58,Progeny,11,17
Col0_32,H,Col0,Low,Vernalized,28,23.53,34,44,50,54,Progeny,10,10
Col0_33,I,Col0,Low,Vernalized,27,31.31,32,39,44,59,Progeny,7,20
Col0_34,J,Col0,Low,Vernalized,24,29.18,30,41,43,57,Progeny,11,16
Col0_35,K,Col0,Low,Vernalized,18,20.29,26,38,42,59,Progeny,12,21
Col0_36,L,Col0,Low,Vernalized,26,32.17,31,40,44,59,Progeny,9,19
Col0_37,A,Col0,Low,Unvernalized,30,35.45,36,45,49,65,Progeny,9,20
Col0_4,D,Col0,High,Vernalized,28,20.84,38,45,47,61,Progeny,7,16
Col0_40,D,Col0,Low,Unvernalized,23,24.89,34,49,51,64,Progeny,15,15
Col0_41,E,Col0,Low,Unvernalized,30,25.59,36,43,46,63,Progeny,7,20
Col0_42,F,Col0,Low,Unvernalized,29,38.83,33,40,43,60,Progeny,7,20
Col0_44,H,Col0,Low,Unvernalized,17,22.49,26,40,42,59,Progeny,14,19
Col0_45,I,Col0,Low,Unvernalized,29,34.21,33,40,42,60,Progeny,7,20
Col0_46,J,Col0,Low,Unvernalized,26,21.47,33,38,41,55,Progeny,5,17
Col0_5,E,Col0,High,Vernalized,24,30.58,30,39,41,56,Progeny,9,17
Col0_6,F,Col0,High,Vernalized,27,30.52,34,42,46,63,Progeny,8,21
Col0_7,G,Col0,High,Vernalized,23,23.19,30,37,40,55,Progeny,7,18
Col0_8,H,Col0,High,Vernalized,25,23.04,33,38,40,60,Progeny,5,22
Col0_9,I,Col0,High,Vernalized,28,35.86,34,40,46,60,Progeny,6,20
Cvi0_1,A,Cvi0,High,Vernalized,15,24.21,27,34,37,56,Progeny,7,22
Cvi0_10,J,Cvi0,High,Vernalized,13,23.65,26,35,38,52,Progeny,9,17
Cvi0_11,K,Cvi0,High,Vernalized,14,20.23,26,34,38,53,Progeny,8,19
Cvi0_12,L,Cvi0,High,Vernalized,16,22.16,30,34,38,54,Progeny,4,20
Cvi0_14,B,Cvi0,High,Unvernalized,16,27.77,29,35,40,54,Progeny,6,19
Cvi0_15,C,Cvi0,High,Unvernalized,14,27,31,40,42,57,Progeny,9,17
Cvi0_16,D,Cvi0,High,Unvernalized,13,23.77,26,34,36,52,Progeny,8,18
Cvi0_17,E,Cvi0,High,Unvernalized,24,25,31,34,37,52,Progeny,3,18
Cvi0_18,F,Cvi0,High,Unvernalized,12,19.79,26,33,36,55,Progeny,7,22
Cvi0_19,G,Cvi0,High,Unvernalized,11,16.06,33,38,40,60,Progeny,5,22
Cvi0_2,B,Cvi0,High,Vernalized,13,18.03,25,33,35,50,Progeny,8,17
Cvi0_20,H,Cvi0,High,Unvernalized,14,23.7,36,41,44,59,Progeny,5,18
Cvi0_21,I,Cvi0,High,Unvernalized,17,31.08,30,36,39,51,Progeny,6,15
Cvi0_23,K,Cvi0,High,Unvernalized,8,8.84,19,26,27,55,Progeny,7,29
Cvi0_24,L,Cvi0,High,Unvernalized,13,23.55,31,38,41,57,Progeny,7,19
Cvi0_25,A,Cvi0,Low,Vernalized,13,24.01,26,33,37,50,Progeny,7,17
Cvi0_27,C,Cvi0,Low,Vernalized,13,22.79,26,33,35,52,Progeny,7,19
Cvi0_29,E,Cvi0,Low,Vernalized,14,24.57,30,36,38,52,Progeny,6,16
Cvi0_3,C,Cvi0,High,Vernalized,17,29.21,29,36,39,55,Progeny,7,19
Cvi0_34,J,Cvi0,Low,Vernalized,18,25.21,30,35,38,51,Progeny,5,16
Cvi0_36,L,Cvi0,Low,Vernalized,16,28.96,31,38,40,57,Progeny,7,19
Cvi0_37,A,Cvi0,Low,Unvernalized,11,17.01,26,34,36,51,Progeny,8,17
Cvi0_38,B,Cvi0,Low,Unvernalized,14,24.82,26,33,36,49,Progeny,7,16
Cvi0_39,C,Cvi0,Low,Unvernalized,16,25.02,25,29,33,49,Progeny,4,20
Cvi0_4,D,Cvi0,High,Vernalized,18,27.59,30,36,39,58,Progeny,6,22
Cvi0_42,F,Cvi0,Low,Unvernalized,12,23.73,27,34,37,56,Progeny,7,22
Cvi0_45,I,Cvi0,Low,Unvernalized,15,29.84,25,31,33,39,Progeny,6,8
Cvi0_46,J,Cvi0,Low,Unvernalized,14,27.33,26,35,37,48,Progeny,9,13
Cvi0_48,L,Cvi0,Low,Unvernalized,18,28.89,26,34,36,55,Progeny,8,21
Cvi0_5,E,Cvi0,High,Vernalized,14,19.28,26,32,35,56,Progeny,6,24
Cvi0_6,F,Cvi0,High,Vernalized,13,21.12,26,33,36,53,Progeny,7,20
Cvi0_7,G,Cvi0,High,Vernalized,18,24.35,34,38,41,56,Progeny,4,18
Cvi0_8,H,Cvi0,High,Vernalized,14,22.59,26,32,35,50,Progeny,6,18
Cvi0_9,I,Cvi0,High,Vernalized,14,27.35,31,38,40,57,Progeny,7,19
Cvi1_1,A,Cvi1,High,Vernalized,20,33.37,33,39,41,58,Progeny,6,19
Cvi1_10,J,Cvi1,High,Vernalized,8,14.16,28,33,37,54,Progeny,5,21
Cvi1_11,K,Cvi1,High,Vernalized,14,25.3,26,35,37,52,Progeny,9,17
Cvi1_13,A,Cvi1,High,Unvernalized,11,16.14,26,35,37,52,Progeny,9,17
Cvi1_14,B,Cvi1,High,Unvernalized,12,16.62,26,35,38,57,Progeny,9,22
Cvi1_15,C,Cvi1,High,Unvernalized,17,28.94,30,34,37,51,Progeny,4,17
Cvi1_16,D,Cvi1,High,Unvernalized,12,22.68,33,40,43,60,Progeny,7,20
Cvi1_17,E,Cvi1,High,Unvernalized,9,11.3,23,30,33,52,Progeny,7,22
Cvi1_19,G,Cvi1,High,Unvernalized,14,25.43,34,42,46,59,Progeny,8,17
Cvi1_2,B,Cvi1,High,Vernalized,12,19.59,32,40,43,60,Progeny,8,20
Cvi1_20,H,Cvi1,High,Unvernalized,13,23.28,25,30,33,51,Progeny,5,21
Cvi1_21,I,Cvi1,High,Unvernalized,14,27,25,30,32,51,Progeny,5,21
Cvi1_22,J,Cvi1,High,Unvernalized,17,27.35,28,37,39,54,Progeny,9,17
Cvi1_26,B,Cvi1,Low,Vernalized,15,27.85,28,33,35,49,Progeny,5,16
Cvi1_28,D,Cvi1,Low,Vernalized,13,24.75,25,33,35,51,Progeny,8,18
Cvi1_29,E,Cvi1,Low,Vernalized,16,23.15,30,37,39,55,Progeny,7,18
Cvi1_3,C,Cvi1,High,Vernalized,17,31.3,30,34,36,52,Progeny,4,18
Cvi1_30,F,Cvi1,Low,Vernalized,15,23,33,42,44,59,Progeny,9,17
Cvi1_32,H,Cvi1,Low,Vernalized,18,28.79,24,29,31,50,Progeny,5,21
Cvi1_34,J,Cvi1,Low,Vernalized,12,21.23,25,31,33,51,Progeny,6,20
Cvi1_38,B,Cvi1,Low,Unvernalized,15,16.98,26,35,38,54,Progeny,9,19
Cvi1_4,D,Cvi1,High,Vernalized,13,20.23,26,33,36,54,Progeny,7,21
Cvi1_5,E,Cvi1,High,Vernalized,10,19.01,32,41,43,61,Progeny,9,20
Cvi1_6,F,Cvi1,High,Vernalized,17,35.8,32,38,40,55,Progeny,6,17
Cvi1_7,G,Cvi1,High,Vernalized,16,29.26,30,35,41,56,Progeny,5,21
Cvi1_8,H,Cvi1,High,Vernalized,14,26.31,26,32,35,52,Progeny,6,20
Cvi1_9,I,Cvi1,High,Vernalized,16,29.7,30,34,36,52,Progeny,4,18
Ler_1,A,Ler,High,Vernalized,16,17.62,26,34,36,54,Progeny,8,20
Ler_11,K,Ler,High,Vernalized,15,21.23,26,35,39,60,Progeny,9,25
Ler_12,L,Ler,High,Vernalized,17,22.23,26,36,39,57,Progeny,10,21
Ler_13,A,Ler,High,Unvernalized,22,19.4,30,39,44,61,Progeny,9,22
Ler_14,B,Ler,High,Unvernalized,21,26.85,32,39,42,60,Progeny,7,21
Ler_15,C,Ler,High,Unvernalized,18,18.98,31,39,42,60,Progeny,8,21
Ler_16,D,Ler,High,Unvernalized,18,18.92,29,36,39,60,Progeny,7,24
Ler_17,E,Ler,High,Unvernalized,20,26.6,28,35,38,56,Progeny,7,21
Ler_18,F,Ler,High,Unvernalized,22,26.72,29,38,40,60,Progeny,9,22
Ler_19,G,Ler,High,Unvernalized,17,21.47,31,39,42,60,Progeny,8,21
Ler_2,B,Ler,High,Vernalized,15,18.87,27,35,38,56,Progeny,8,21
Ler_20,H,Ler,High,Unvernalized,17,22.67,24,37,38,59,Progeny,13,22
Ler_21,I,Ler,High,Unvernalized,16,26.6,25,32,35,60,Progeny,7,28
Ler_22,J,Ler,High,Unvernalized,16,19.26,25,35,39,60,Progeny,10,25
Ler_23,K,Ler,High,Unvernalized,16,21.07,26,33,35,54,Progeny,7,21
Ler_26,B,Ler,Low,Vernalized,15,16.55,32,41,45,61,Progeny,9,20
Ler_27,C,Ler,Low,Vernalized,16,19.89,25,35,39,60,Progeny,10,25
Ler_28,D,Ler,Low,Vernalized,18,19.7,28,35,39,57,Progeny,7,22
Ler_29,E,Ler,Low,Vernalized,25,21.21,30,40,43,62,Progeny,10,22
Ler_3,C,Ler,High,Vernalized,16,17.76,32,40,44,59,Progeny,8,19
Ler_30,F,Ler,Low,Vernalized,15,20.07,26,35,39,57,Progeny,9,22
Ler_31,G,Ler,Low,Vernalized,14,17.69,31,39,42,59,Progeny,8,20
Ler_32,H,Ler,Low,Vernalized,21,23.79,23,31,35,56,Progeny,8,25
Ler_33,I,Ler,Low,Vernalized,18,23.76,30,37,40,57,Progeny,7,20
Ler_34,J,Ler,Low,Vernalized,18,20.86,26,37,40,59,Progeny,11,22
Ler_35,K,Ler,Low,Vernalized,16,18.64,25,33,36,53,Progeny,8,20
Ler_36,L,Ler,Low,Vernalized,16,23.25,26,37,40,59,Progeny,11,22
Ler_37,A,Ler,Low,Unvernalized,20,23.23,30,40,42,60,Progeny,10,20
Ler_38,B,Ler,Low,Unvernalized,14,20.99,25,32,36,52,Progeny,7,20
Ler_39,C,Ler,Low,Unvernalized,17,25.23,22,30,33,57,Progeny,8,27
Ler_4,D,Ler,High,Vernalized,18,22.82,28,37,40,56,Progeny,9,19
Ler_40,D,Ler,Low,Unvernalized,19,27.02,28,36,39,57,Progeny,8,21
Ler_41,E,Ler,Low,Unvernalized,17,22.26,25,33,36,54,Progeny,8,21
Ler_42,F,Ler,Low,Unvernalized,18,24.37,32,38,42,57,Progeny,6,19
Ler_43,G,Ler,Low,Unvernalized,17,20.72,30,39,45,60,Progeny,9,21
Ler_44,H,Ler,Low,Unvernalized,16,22.42,27,33,36,55,Progeny,6,22
Ler_45,I,Ler,Low,Unvernalized,17,20.39,26,33,35,55,Progeny,7,22
Ler_46,J,Ler,Low,Unvernalized,16,16.33,26,35,39,57,Progeny,9,22
Ler_47,K,Ler,Low,Unvernalized,15,21.57,25,33,37,52,Progeny,8,19
Ler_48,L,Ler,Low,Unvernalized,15,18.91,26,37,40,57,Progeny,11,20
Ler_5,E,Ler,High,Vernalized,18,25.35,28,36,39,58,Progeny,8,22
Ler_6,F,Ler,High,Vernalized,22,26.63,29,36,39,60,Progeny,7,24
Ler_7,G,Ler,High,Vernalized,18,16.15,35,44,47,63,Progeny,9,19
Ler_8,H,Ler,High,Vernalized,14,19.67,26,35,37,54,Progeny,9,19
Ler_9,I,Ler,High,Vernalized,15,20.52,23,31,34,51,Progeny,8,20
Ler2_1,A,Ler2,High,Vernalized,15,23.67,26,35,38,57,Progeny,9,22
Ler2_10,J,Ler2,High,Vernalized,17,20.74,25,32,35,52,Progeny,7,20
Ler2_11,K,Ler2,High,Vernalized,13,23.21,23,33,38,59,Progeny,10,26
Ler2_12,L,Ler2,High,Vernalized,13,15.82,23,32,35,59,Progeny,9,27
Ler2_13,A,Ler2,High,Unvernalized,16,30.35,24,32,35,59,Progeny,8,27
Ler2_14,B,Ler2,High,Unvernalized,15,19.1,26,35,37,55,Progeny,9,20
Ler2_15,C,Ler2,High,Unvernalized,18,22.87,26,34,36,54,Progeny,8,20
Ler2_16,D,Ler2,High,Unvernalized,19,27.22,28,36,40,55,Progeny,8,19
Ler2_17,E,Ler2,High,Unvernalized,18,22.29,28,39,41,58,Progeny,11,19
Ler2_18,F,Ler2,High,Unvernalized,22,27.21,28,39,41,57,Progeny,11,18
Ler2_19,G,Ler2,High,Unvernalized,16,16.23,30,38,42,59,Progeny,8,21
Ler2_20,H,Ler2,High,Unvernalized,19,27.65,23,26,36,51,Progeny,3,25
Ler2_21,I,Ler2,High,Unvernalized,18,21.31,26,33,36,57,Progeny,7,24
Ler2_22,J,Ler2,High,Unvernalized,14,14.69,24,31,34,51,Progeny,7,20
Ler2_23,K,Ler2,High,Unvernalized,17,17.42,26,34,36,54,Progeny,8,20
Ler2_24,L,Ler2,High,Unvernalized,12,11.74,20,27,38,59,Progeny,7,32
Ler2_25,A,Ler2,Low,Vernalized,14,18.98,24,35,37,57,Progeny,11,22
Ler2_26,B,Ler2,Low,Vernalized,16,23.1,28,36,40,57,Progeny,8,21
Ler2_27,C,Ler2,Low,Vernalized,18,24.28,25,32,35,60,Progeny,7,28
Ler2_28,D,Ler2,Low,Vernalized,16,20.9,26,36,40,56,Progeny,10,20
Ler2_29,E,Ler2,Low,Vernalized,15,15.61,26,37,41,57,Progeny,11,20
Ler2_3,C,Ler2,High,Vernalized,17,24.16,28,37,39,56,Progeny,9,19
Ler2_30,F,Ler2,Low,Vernalized,18,25.21,31,40,43,62,Progeny,9,22
Ler2_32,H,Ler2,Low,Vernalized,15,21.27,26,33,37,53,Progeny,7,20
Ler2_33,I,Ler2,Low,Vernalized,15,22.38,25,33,36,57,Progeny,8,24
Ler2_34,J,Ler2,Low,Vernalized,16,16.35,26,35,39,55,Progeny,9,20
Ler2_35,K,Ler2,Low,Vernalized,15,21.89,26,32,36,55,Progeny,6,23
Ler2_36,L,Ler2,Low,Vernalized,19,35.31,29,36,39,56,Progeny,7,20
Ler2_37,A,Ler2,Low,Unvernalized,17,30.62,39,49,51,67,Progeny,10,18
Ler2_38,B,Ler2,Low,Unvernalized,17,22.25,26,35,39,60,Progeny,9,25
Ler2_39,C,Ler2,Low,Unvernalized,18,21.76,23,34,35,54,Progeny,11,20
Ler2_4,D,Ler2,High,Vernalized,16,18.01,25,35,37,58,Progeny,10,23
Ler2_40,D,Ler2,Low,Unvernalized,17,21.01,26,35,38,55,Progeny,9,20
Ler2_41,E,Ler2,Low,Unvernalized,16,24.88,25,33,36,60,Progeny,8,27
Ler2_43,G,Ler2,Low,Unvernalized,17,19.02,30,39,41,58,Progeny,9,19
Ler2_44,H,Ler2,Low,Unvernalized,17,22.68,26,33,37,52,Progeny,7,19
Ler2_46,J,Ler2,Low,Unvernalized,16,22.69,29,36,38,55,Progeny,7,19
Ler2_47,K,Ler2,Low,Unvernalized,14,17.86,26,33,37,52,Progeny,7,19
Ler2_48,L,Ler2,Low,Unvernalized,18,23.29,26,36,39,57,Progeny,10,21
Ler2_7,G,Ler2,High,Vernalized,17,27.83,34,43,45,61,Progeny,9,18
Ler2_9,I,Ler2,High,Vernalized,17,26.03,23,32,36,57,Progeny,9,25
Wa1_1,A,Wa1,High,Vernalized,15,20.28,21,30,33,54,Progeny,9,24
Wa1_10,J,Wa1,High,Vernalized,16,13.58,26,32,35,53,Progeny,6,21
Wa1_11,K,Wa1,High,Vernalized,12,15.8,22,30,31,56,Progeny,8,26
Wa1_12,L,Wa1,High,Vernalized,15,23.84,23,31,34,51,Progeny,8,20
Wa1_13,A,Wa1,High,Unvernalized,12,18.89,21,31,34,55,Progeny,10,24
Wa1_14,B,Wa1,High,Unvernalized,13,16.01,25,34,37,53,Progeny,9,19
Wa1_15,C,Wa1,High,Unvernalized,14,12.34,18,29,32,51,Progeny,11,22
Wa1_17,E,Wa1,High,Unvernalized,12,15.31,22,32,33,54,Progeny,10,22
Wa1_18,F,Wa1,High,Unvernalized,16,24.45,27,37,40,55,Progeny,10,18
Wa1_19,G,Wa1,High,Unvernalized,17,18.61,29,38,43,55,Progeny,9,17
Wa1_2,B,Wa1,High,Vernalized,11,15.22,22,31,35,50,Progeny,9,19
Wa1_20,H,Wa1,High,Unvernalized,14,16.49,32,38,44,57,Progeny,6,19
Wa1_21,I,Wa1,High,Unvernalized,16,14.9,31,37,41,59,Progeny,6,22
Wa1_22,J,Wa1,High,Unvernalized,13,11.95,22,30,31,56,Progeny,8,26
Wa1_23,K,Wa1,High,Unvernalized,12,13.05,35,45,51,62,Progeny,10,17
Wa1_24,L,Wa1,High,Unvernalized,18,25.1,27,35,38,55,Progeny,8,20
Wa1_25,A,Wa1,Low,Vernalized,14,7.37,23,42,46,60,Progeny,19,18
Wa1_26,B,Wa1,Low,Vernalized,16,19.02,25,33,36,51,Progeny,8,18
Wa1_27,C,Wa1,Low,Vernalized,13,17.08,35,45,48,61,Progeny,10,16
Wa1_28,D,Wa1,Low,Vernalized,13,12.24,26,37,44,57,Progeny,11,20
Wa1_29,E,Wa1,Low,Vernalized,15,14.78,26,35,40,54,Progeny,9,19
Wa1_3,C,Wa1,High,Vernalized,14,16.78,22,30,32,51,Progeny,8,21
Wa1_30,F,Wa1,Low,Vernalized,20,28.52,41,47,50,67,Progeny,6,20
Wa1_31,G,Wa1,Low,Vernalized,16,13.28,30,41,45,61,Progeny,11,20
Wa1_32,H,Wa1,Low,Vernalized,16,21.66,25,34,36,44,Progeny,9,10
Wa1_33,I,Wa1,Low,Vernalized,17,22.44,26,33,38,52,Progeny,7,19
Wa1_34,J,Wa1,Low,Vernalized,13,12.54,22,32,36,50,Progeny,10,18
Wa1_35,K,Wa1,Low,Vernalized,15,17.63,23,32,34,54,Progeny,9,22
Wa1_36,L,Wa1,Low,Vernalized,16,22.29,25,33,39,53,Progeny,8,20
Wa1_37,A,Wa1,Low,Unvernalized,16,26.12,23,31,34,51,Progeny,8,20
Wa1_38,B,Wa1,Low,Unvernalized,16,19.74,22,30,33,54,Progeny,8,24
Wa1_39,C,Wa1,Low,Unvernalized,14,19.63,22,29,32,60,Progeny,7,31
Wa1_4,D,Wa1,High,Vernalized,15,16.42,23,30,34,54,Progeny,7,24
Wa1_40,D,Wa1,Low,Unvernalized,14,15.09,26,36,38,54,Progeny,10,18
Wa1_41,E,Wa1,Low,Unvernalized,14,17.51,22,35,39,60,Progeny,13,25
Wa1_42,F,Wa1,Low,Unvernalized,18,25.71,23,35,40,57,Progeny,12,22
Wa1_43,G,Wa1,Low,Unvernalized,19,22.34,27,38,42,55,Progeny,11,17
Wa1_44,H,Wa1,Low,Unvernalized,13,18.53,21,30,33,54,Progeny,9,24
Wa1_46,J,Wa1,Low,Unvernalized,12,16.99,21,29,37,57,Progeny,8,28
Wa1_47,K,Wa1,Low,Unvernalized,13,16.39,33,41,45,60,Progeny,8,19
Wa1_48,L,Wa1,Low,Unvernalized,15,20.52,27,36,38,42,Progeny,9,6
Wa1_5,E,Wa1,High,Vernalized,12,15.34,21,31,36,55,Progeny,10,24
Wa1_6,F,Wa1,High,Vernalized,16,22.09,26,35,39,60,Progeny,9,25
Wa1_8,H,Wa1,High,Vernalized,13,13.98,22,30,33,51,Progeny,8,21
Wa1_9,I,Wa1,High,Vernalized,11,12.88,18,29,33,54,Progeny,11,25
Ws1_1,A,Ws1,High,Vernalized,13,17.93,22,27,31,59,Progeny,5,32
Ws1_10,J,Ws1,High,Vernalized,15,17.37,26,33,35,55,Progeny,7,22
Ws1_11,K,Ws1,High,Vernalized,13,13.33,22,31,33,53,Progeny,9,22
Ws1_12,L,Ws1,High,Vernalized,14,14.34,32,42,45,66,Progeny,10,24
Ws1_13,A,Ws1,High,Unvernalized,15,17.72,26,33,35,52,Progeny,7,19
Ws1_14,B,Ws1,High,Unvernalized,14,16.09,21,24,31,52,Progeny,3,28
Ws1_15,C,Ws1,High,Unvernalized,15,17.72,18,27,30,51,Progeny,9,24
Ws1_16,D,Ws1,High,Unvernalized,15,16.84,21,30,33,54,Progeny,9,24
Ws1_17,E,Ws1,High,Unvernalized,14,17.42,22,30,32,51,Progeny,8,21
Ws1_19,G,Ws1,High,Unvernalized,14,17.79,22,29,32,51,Progeny,7,22
Ws1_2,B,Ws1,High,Vernalized,14,23.68,29,37,40,60,Progeny,8,23
Ws1_21,I,Ws1,High,Unvernalized,14,18.93,21,29,33,54,Progeny,8,25
Ws1_22,J,Ws1,High,Unvernalized,16,18.2,26,32,35,55,Progeny,6,23
Ws1_23,K,Ws1,High,Unvernalized,12,16.24,22,28,32,60,Progeny,6,32
Ws1_24,L,Ws1,High,Unvernalized,15,20.79,26,35,37,58,Progeny,9,23
Ws1_25,A,Ws1,Low,Vernalized,12,15.61,22,26,29,50,Progeny,4,24
Ws1_26,B,Ws1,Low,Vernalized,15,17.28,20,28,31,52,Progeny,8,24
Ws1_27,C,Ws1,Low,Vernalized,13,17.27,18,27,30,51,Progeny,9,24
Ws1_28,D,Ws1,Low,Vernalized,14,15.44,21,29,31,56,Progeny,8,27
Ws1_29,E,Ws1,Low,Vernalized,16,18.35,22,30,33,54,Progeny,8,24
Ws1_3,C,Ws1,High,Vernalized,11,13.25,24,35,36,57,Progeny,11,22
Ws1_30,F,Ws1,Low,Vernalized,14,13.82,22,29,32,51,Progeny,7,22
Ws1_31,G,Ws1,Low,Vernalized,16,17.64,26,34,36,55,Progeny,8,21
Ws1_32,H,Ws1,Low,Vernalized,17,22.08,27,33,36,55,Progeny,6,22
Ws1_33,I,Ws1,Low,Vernalized,11,14.32,22,32,33,52,Progeny,10,20
Ws1_34,J,Ws1,Low,Vernalized,14,17.54,23,30,31,59,Progeny,7,29
Ws1_35,K,Ws1,Low,Vernalized,14,20.92,22,31,33,57,Progeny,9,26
Ws1_36,L,Ws1,Low,Vernalized,16,21.26,25,32,36,60,Progeny,7,28
Ws1_37,A,Ws1,Low,Unvernalized,14,16.81,20,30,31,51,Progeny,10,21
Ws1_38,B,Ws1,Low,Unvernalized,17,24.8,22,32,36,57,Progeny,10,25
Ws1_39,C,Ws1,Low,Unvernalized,17,22.45,22,30,33,54,Progeny,8,24
Ws1_40,D,Ws1,Low,Unvernalized,18,20.83,22,30,33,54,Progeny,8,24
Ws1_41,E,Ws1,Low,Unvernalized,18,23.49,22,31,38,57,Progeny,9,26
Ws1_42,F,Ws1,Low,Unvernalized,16,20.17,25,31,35,52,Progeny,6,21
Ws1_43,G,Ws1,Low,Unvernalized,16,21.45,24,30,32,51,Progeny,6,21
Ws1_44,H,Ws1,Low,Unvernalized,14,20.53,22,27,31,57,Progeny,5,30
Ws1_45,I,Ws1,Low,Unvernalized,14,17.84,23,30,40,59,Progeny,7,29
Ws1_46,J,Ws1,Low,Unvernalized,17,17.55,18,30,33,49,Progeny,12,19
Ws1_47,K,Ws1,Low,Unvernalized,13,15.84,23,30,33,52,Progeny,7,22
Ws1_48,L,Ws1,Low,Unvernalized,15,23.58,21,29,34,55,Progeny,8,26
Ws1_5,E,Ws1,High,Vernalized,16,16.72,22,40,43,62,Progeny,18,22
Ws1_6,F,Ws1,High,Vernalized,14,20.97,20,30,34,56,Progeny,10,26
Ws1_7,G,Ws1,High,Vernalized,16,17.37,28,38,40,57,Progeny,10,19
Ws1_8,H,Ws1,High,Vernalized,14,18.8,21,30,34,55,Progeny,9,25
Ws1_9,I,Ws1,High,Vernalized,14,17.89,21,29,33,52,Progeny,8,23
PV3_1,A,Ag0,High,Unvernalized,13,23.55,21,27,31,43,Grandprogeny,6,16
PV3_10,J,Ag0,High,Unvernalized,19,26.11,22,27,32,43,Grandprogeny,5,16
PV3_100,D,Cvi0,High,Unvernalized,30,34.11,42,48,50,66,Grandprogeny,6,18
PV3_101,E,Cvi0,High,Unvernalized,24,46.76,37,42,43,61,Grandprogeny,5,19
PV3_102,F,Cvi0,High,Unvernalized,25,42.98,35,39,43,58,Grandprogeny,4,19
PV3_103,G,Cvi0,High,Unvernalized,24,48.5,32,39,43,56,Grandprogeny,7,17
PV3_104,H,Cvi0,High,Unvernalized,18,27.92,36,40,42,60,Grandprogeny,4,20
PV3_105,I,Cvi0,High,Unvernalized,32,45.17,37,42,48,63,Grandprogeny,5,21
PV3_106,J,Cvi0,High,Unvernalized,15,32.9,27,33,36,52,Grandprogeny,6,19
PV3_107,K,Cvi0,High,Unvernalized,14,22.14,21,29,32,49,Grandprogeny,8,20
PV3_108,L,Cvi0,High,Unvernalized,20,29.68,37,42,45,58,Grandprogeny,5,16
PV3_109,A,Cvi0,High,Vernalized,26,42.48,36,40,44,61,Grandprogeny,4,21
PV3_11,K,Ag0,High,Unvernalized,18,23.63,20,27,29,44,Grandprogeny,7,17
PV3_110,B,Cvi0,High,Vernalized,24,42.97,29,34,38,52,Grandprogeny,5,18
PV3_111,C,Cvi0,High,Vernalized,17,41.2,29,35,38,50,Grandprogeny,6,15
PV3_112,D,Cvi0,High,Vernalized,22,37.29,35,40,44,60,Grandprogeny,5,20
PV3_113,E,Cvi0,High,Vernalized,27,45.26,37,41,44,60,Grandprogeny,4,19
PV3_114,F,Cvi0,High,Vernalized,22,47.46,32,36,41,55,Grandprogeny,4,19
PV3_115,G,Cvi0,High,Vernalized,25,49.48,35,40,43,57,Grandprogeny,5,17
PV3_116,H,Cvi0,High,Vernalized,14,30.24,28,33,36,50,Grandprogeny,5,17
PV3_117,I,Cvi0,High,Vernalized,18,43.94,29,35,37,50,Grandprogeny,6,15
PV3_118,J,Cvi0,High,Vernalized,23,48.71,34,39,43,55,Grandprogeny,5,16
PV3_119,K,Cvi0,High,Vernalized,24,44.69,35,40,44,60,Grandprogeny,5,20
PV3_12,L,Ag0,High,Unvernalized,19,28.61,22,27,31,43,Grandprogeny,5,16
PV3_120,L,Cvi0,High,Vernalized,22,41.12,35,40,44,58,Grandprogeny,5,18
PV3_121,A,Cvi0,Low,Unvernalized,16,40.02,28,34,37,50,Grandprogeny,6,16
PV3_122,B,Cvi0,Low,Unvernalized,25,47.4,36,40,45,62,Grandprogeny,4,22
PV3_123,C,Cvi0,Low,Unvernalized,21,30.36,27,32,37,56,Grandprogeny,5,24
PV3_124,D,Cvi0,Low,Unvernalized,24,32.71,27,32,36,50,Grandprogeny,5,18
PV3_125,E,Cvi0,Low,Unvernalized,22,27.22,24,33,34,50,Grandprogeny,9,17
PV3_126,F,Cvi0,Low,Unvernalized,20,27.78,24,30,34,50,Grandprogeny,6,20
PV3_127,G,Cvi0,Low,Unvernalized,18,26.76,24,32,34,49,Grandprogeny,8,17
PV3_128,H,Cvi0,Low,Unvernalized,34,50.62,37,41,44,60,Grandprogeny,4,19
PV3_129,I,Cvi0,Low,Unvernalized,24,49.77,34,38,42,60,Grandprogeny,4,22
PV3_13,A,Ag0,High,Vernalized,20,25.2,22,27,31,44,Grandprogeny,5,17
PV3_130,J,Cvi0,Low,Unvernalized,19,28.91,24,31,34,50,Grandprogeny,7,19
PV3_131,K,Cvi0,Low,Unvernalized,17,26.96,24,29,32,50,Grandprogeny,5,21
PV3_132,L,Cvi0,Low,Unvernalized,16,40.63,29,34,38,55,Grandprogeny,5,21
PV3_133,A,Cvi0,Low,Vernalized,28,32.98,28,33,37,50,Grandprogeny,5,17
PV3_134,B,Cvi0,Low,Vernalized,21,43.87,34,39,42,60,Grandprogeny,5,21
PV3_135,C,Cvi0,Low,Vernalized,37,41.01,30,35,39,55,Grandprogeny,5,20
PV3_136,D,Cvi0,Low,Vernalized,17,40.21,29,34,37,52,Grandprogeny,5,18
PV3_137,E,Cvi0,Low,Vernalized,43,36.58,31,36,39,55,Grandprogeny,5,19
PV3_138,F,Cvi0,Low,Vernalized,36,42.31,32,39,42,56,Grandprogeny,7,17
PV3_139,G,Cvi0,Low,Vernalized,44,44.6,35,40,43,60,Grandprogeny,5,20
PV3_14,B,Ag0,High,Vernalized,43,38.65,29,34,38,52,Grandprogeny,5,18
PV3_140,H,Cvi0,Low,Vernalized,28,33.95,29,35,37,52,Grandprogeny,6,17
PV3_141,I,Cvi0,Low,Vernalized,45,41.57,32,37,41,55,Grandprogeny,5,18
PV3_142,J,Cvi0,Low,Vernalized,39,39.38,35,42,49,60,Grandprogeny,7,18
PV3_143,K,Cvi0,Low,Vernalized,39,37.21,31,36,40,55,Grandprogeny,5,19
PV3_144,L,Cvi0,Low,Vernalized,40,42.32,33,38,43,57,Grandprogeny,5,19
PV3_145,A,Cvi1,High,Unvernalized,19,51.1,39,44,49,68,Grandprogeny,5,24
PV3_146,B,Cvi1,High,Unvernalized,29,49.06,36,41,45,61,Grandprogeny,5,20
PV3_147,C,Cvi1,High,Unvernalized,20,41.19,28,34,37,55,Grandprogeny,6,21
PV3_148,D,Cvi1,High,Unvernalized,25,41.9,30,35,38,55,Grandprogeny,5,20
PV3_149,E,Cvi1,High,Unvernalized,29,50.07,36,40,44,63,Grandprogeny,4,23
PV3_15,C,Ag0,High,Vernalized,24,32.19,24,29,32,44,Grandprogeny,5,15
PV3_150,F,Cvi1,High,Unvernalized,21,48.94,31,34,39,55,Grandprogeny,3,21
PV3_151,G,Cvi1,High,Unvernalized,21,42.53,29,34,37,52,Grandprogeny,5,18
PV3_152,H,Cvi1,High,Unvernalized,21,42.08,34,39,42,60,Grandprogeny,5,21
PV3_153,I,Cvi1,High,Unvernalized,26,47.35,33,38,42,58,Grandprogeny,5,20
PV3_154,J,Cvi1,High,Unvernalized,16,40.57,27,31,34,48,Grandprogeny,4,17
PV3_155,K,Cvi1,High,Unvernalized,26,40.81,35,40,45,61,Grandprogeny,5,21
PV3_156,L,Cvi1,High,Unvernalized,20,44.77,34,38,42,58,Grandprogeny,4,20
PV3_157,A,Cvi1,High,Vernalized,25,43.22,36,41,48,64,Grandprogeny,5,23
PV3_158,B,Cvi1,High,Vernalized,22,40.42,34,38,43,58,Grandprogeny,4,20
PV3_159,C,Cvi1,High,Vernalized,18,42.99,29,35,38,50,Grandprogeny,6,15
PV3_16,D,Ag0,High,Vernalized,41,33.09,30,34,36,50,Grandprogeny,4,16
PV3_160,D,Cvi1,High,Vernalized,27,50.6,33,37,40,58,Grandprogeny,4,21
PV3_161,E,Cvi1,High,Vernalized,21,32.89,32,36,39,55,Grandprogeny,4,19
PV3_162,F,Cvi1,High,Vernalized,18,40.88,31,36,40,51,Grandprogeny,5,15
PV3_163,G,Cvi1,High,Vernalized,28,35.65,36,41,43,60,Grandprogeny,5,19
PV3_164,H,Cvi1,High,Vernalized,22,39.28,32,36,38,51,Grandprogeny,4,15
PV3_165,I,Cvi1,High,Vernalized,22,32.83,35,40,43,55,Grandprogeny,5,15
PV3_166,J,Cvi1,High,Vernalized,20,34.27,32,37,41,52,Grandprogeny,5,15
PV3_167,K,Cvi1,High,Vernalized,22,41.3,29,33,36,48,Grandprogeny,4,15
PV3_168,L,Cvi1,High,Vernalized,18,36.7,27,31,34,48,Grandprogeny,4,17
PV3_169,A,Cvi1,Low,Unvernalized,18,21.16,23,30,32,48,Grandprogeny,7,18
PV3_17,E,Ag0,High,Vernalized,16,27.09,23,28,32,43,Grandprogeny,5,15
PV3_170,B,Cvi1,Low,Unvernalized,17,26,23,31,34,48,Grandprogeny,8,17
PV3_171,C,Cvi1,Low,Unvernalized,17,24.2,23,31,33,48,Grandprogeny,8,17
PV3_172,D,Cvi1,Low,Unvernalized,19,27.32,23,30,33,48,Grandprogeny,7,18
PV3_173,E,Cvi1,Low,Unvernalized,18,25.44,24,31,34,50,Grandprogeny,7,19
PV3_174,F,Cvi1,Low,Unvernalized,24,30.15,24,30,34,48,Grandprogeny,6,18
PV3_175,G,Cvi1,Low,Unvernalized,24,30.57,23,30,33,48,Grandprogeny,7,18
PV3_176,H,Cvi1,Low,Unvernalized,20,28.61,23,30,33,48,Grandprogeny,7,18
PV3_177,I,Cvi1,Low,Unvernalized,32,28.32,27,32,35,50,Grandprogeny,5,18
PV3_178,J,Cvi1,Low,Unvernalized,18,29.87,23,30,33,48,Grandprogeny,7,18
PV3_179,K,Cvi1,Low,Unvernalized,16,24.26,23,31,34,48,Grandprogeny,8,17
PV3_18,F,Ag0,High,Vernalized,12,22.29,20,27,31,43,Grandprogeny,7,16
PV3_180,L,Cvi1,Low,Unvernalized,14,22.25,22,30,33,48,Grandprogeny,8,18
PV3_181,A,Cvi1,Low,Vernalized,14,36.5,27,30,33,48,Grandprogeny,3,18
PV3_182,B,Cvi1,Low,Vernalized,16,37.96,27,32,34,49,Grandprogeny,5,17
PV3_183,C,Cvi1,Low,Vernalized,15,37.69,27,32,34,49,Grandprogeny,5,17
PV3_184,D,Cvi1,Low,Vernalized,22,41.23,31,36,40,51,Grandprogeny,5,15
PV3_185,E,Cvi1,Low,Vernalized,16,36.94,27,34,34,48,Grandprogeny,7,14
PV3_186,F,Cvi1,Low,Vernalized,22,41.99,32,36,39,51,Grandprogeny,4,15
PV3_188,H,Cvi1,Low,Vernalized,19,37.91,31,36,40,55,Grandprogeny,5,19
PV3_189,I,Cvi1,Low,Vernalized,22,44.68,30,34,37,52,Grandprogeny,4,18
PV3_19,G,Ag0,High,Vernalized,18,29.92,22,27,31,43,Grandprogeny,5,16
PV3_190,J,Cvi1,Low,Vernalized,19,39.71,33,38,41,55,Grandprogeny,5,17
PV3_191,K,Cvi1,Low,Vernalized,25,45.13,33,36,39,52,Grandprogeny,3,16
PV3_192,L,Cvi1,Low,Vernalized,24,43.81,31,36,38,52,Grandprogeny,5,16
PV3_193,A,Ler,High,Unvernalized,20,24.48,23,30,33,49,Grandprogeny,7,19
PV3_194,B,Ler,High,Unvernalized,14,19.22,22,29,31,48,Grandprogeny,7,19
PV3_195,C,Ler,High,Unvernalized,15,23.75,22,33,36,50,Grandprogeny,11,17
PV3_196,D,Ler,High,Unvernalized,15,13.22,23,29,32,48,Grandprogeny,6,19
PV3_197,E,Ler,High,Unvernalized,17,22.94,23,30,33,48,Grandprogeny,7,18
PV3_198,F,Ler,High,Unvernalized,20,27.17,23,30,33,48,Grandprogeny,7,18
PV3_199,G,Ler,High,Unvernalized,17,24.8,22,29,34,49,Grandprogeny,7,20
PV3_2,B,Ag0,High,Unvernalized,43,33.62,24,29,32,44,Grandprogeny,5,15
PV3_20,H,Ag0,High,Vernalized,28,31.19,24,31,32,48,Grandprogeny,7,17
PV3_200,H,Ler,High,Unvernalized,23,22.57,23,30,33,48,Grandprogeny,7,18
PV3_201,I,Ler,High,Unvernalized,18,23.69,23,29,33,48,Grandprogeny,6,19
PV3_202,J,Ler,High,Unvernalized,19,23.33,22,29,33,48,Grandprogeny,7,19
PV3_203,K,Ler,High,Unvernalized,22,25.05,23,30,34,48,Grandprogeny,7,18
PV3_204,L,Ler,High,Unvernalized,14,16.49,21,28,31,45,Grandprogeny,7,17
PV3_205,A,Ler,High,Vernalized,22,27.69,22,30,33,49,Grandprogeny,8,19
PV3_206,B,Ler,High,Vernalized,22,29.21,23,30,33,48,Grandprogeny,7,18
PV3_207,C,Ler,High,Vernalized,24,27.36,23,30,34,48,Grandprogeny,7,18
PV3_208,D,Ler,High,Vernalized,15,21.34,22,30,32,48,Grandprogeny,8,18
PV3_209,E,Ler,High,Vernalized,20,26.2,23,29,33,49,Grandprogeny,6,20
PV3_21,I,Ag0,High,Vernalized,47,41.28,32,35,40,55,Grandprogeny,3,20
PV3_210,F,Ler,High,Vernalized,31,35.8,27,31,34,50,Grandprogeny,4,19
PV3_211,G,Ler,High,Vernalized,21,25.74,23,30,33,48,Grandprogeny,7,18
PV3_212,H,Ler,High,Vernalized,23,27.25,23,30,33,48,Grandprogeny,7,18
PV3_213,I,Ler,High,Vernalized,22,27.26,23,30,34,48,Grandprogeny,7,18
PV3_214,J,Ler,High,Vernalized,18,16.92,21,28,30,48,Grandprogeny,7,20
PV3_215,K,Ler,High,Vernalized,23,22.25,23,30,34,48,Grandprogeny,7,18
PV3_216,L,Ler,High,Vernalized,24,31.23,24,31,33,49,Grandprogeny,7,18
PV3_217,A,Ler,Low,Unvernalized,22,24.87,24,31,34,49,Grandprogeny,7,18
PV3_218,B,Ler,Low,Unvernalized,23,24.37,24,35,38,55,Grandprogeny,11,20
PV3_219,C,Ler,Low,Unvernalized,20,25.33,23,30,32,48,Grandprogeny,7,18
PV3_22,J,Ag0,High,Vernalized,21,28.04,24,29,33,45,Grandprogeny,5,16
PV3_220,D,Ler,Low,Unvernalized,17,22.17,24,30,33,50,Grandprogeny,6,20
PV3_221,E,Ler,Low,Unvernalized,21,28.1,24,31,34,48,Grandprogeny,7,17
PV3_222,F,Ler,Low,Unvernalized,19,22.91,23,29,33,48,Grandprogeny,6,19
PV3_223,G,Ler,Low,Unvernalized,29,30.85,24,30,33,48,Grandprogeny,6,18
PV3_224,H,Ler,Low,Unvernalized,26,29.64,24,30,34,48,Grandprogeny,6,18
PV3_225,I,Ler,Low,Unvernalized,17,20.87,23,28,32,48,Grandprogeny,5,20
PV3_226,J,Ler,Low,Unvernalized,18,22.86,22,28,32,45,Grandprogeny,6,17
PV3_227,K,Ler,Low,Unvernalized,21,24.46,23,28,31,45,Grandprogeny,5,17
PV3_228,L,Ler,Low,Unvernalized,22,25.3,23,29,33,48,Grandprogeny,6,19
PV3_229,A,Ler,Low,Vernalized,22,26.17,23,29,32,48,Grandprogeny,6,19
PV3_23,K,Ag0,High,Vernalized,18,27.07,22,28,32,44,Grandprogeny,6,16
PV3_230,B,Ler,Low,Vernalized,25,27.28,24,30,32,48,Grandprogeny,6,18
PV3_231,C,Ler,Low,Vernalized,21,27.06,24,31,32,49,Grandprogeny,7,18
PV3_232,D,Ler,Low,Vernalized,17,25.4,24,30,33,48,Grandprogeny,6,18
PV3_233,E,Ler,Low,Vernalized,20,26.42,23,31,33,48,Grandprogeny,8,17
PV3_234,F,Ler,Low,Vernalized,31,31.87,27,31,34,49,Grandprogeny,4,18
PV3_235,G,Ler,Low,Vernalized,21,28.07,23,29,33,48,Grandprogeny,6,19
PV3_236,H,Ler,Low,Vernalized,20,28.42,23,29,32,48,Grandprogeny,6,19
PV3_237,I,Ler,Low,Vernalized,18,26.03,22,27,30,44,Grandprogeny,5,17
PV3_238,J,Ler,Low,Vernalized,16,27.56,24,31,34,48,Grandprogeny,7,17
PV3_239,K,Ler,Low,Vernalized,24,24.49,23,30,33,48,Grandprogeny,7,18
PV3_24,L,Ag0,High,Vernalized,32,32.19,27,32,34,49,Grandprogeny,5,17
PV3_240,L,Ler,Low,Vernalized,24,29.2,23,29,33,48,Grandprogeny,6,19
PV3_241,A,Ler2,High,Unvernalized,17,24.12,24,31,34,48,Grandprogeny,7,17
PV3_242,B,Ler2,High,Unvernalized,29,31.67,27,32,35,49,Grandprogeny,5,17
PV3_243,C,Ler2,High,Unvernalized,23,25.78,23,29,32,48,Grandprogeny,6,19
PV3_244,D,Ler2,High,Unvernalized,16,24.19,23,30,33,48,Grandprogeny,7,18
PV3_245,E,Ler2,High,Unvernalized,21,23.52,23,29,33,48,Grandprogeny,6,19
PV3_246,F,Ler2,High,Unvernalized,21,23.39,23,29,32,48,Grandprogeny,6,19
PV3_247,G,Ler2,High,Unvernalized,18,25.98,23,29,31,45,Grandprogeny,6,16
PV3_248,H,Ler2,High,Unvernalized,19,23.95,23,29,33,48,Grandprogeny,6,19
PV3_249,I,Ler2,High,Unvernalized,15,20.14,23,29,33,48,Grandprogeny,6,19
PV3_25,A,Ag0,Low,Unvernalized,16,26.04,22,28,31,48,Grandprogeny,6,20
PV3_250,J,Ler2,High,Unvernalized,18,24.91,23,29,33,48,Grandprogeny,6,19
PV3_251,K,Ler2,High,Unvernalized,17,23.02,23,28,32,45,Grandprogeny,5,17
PV3_252,L,Ler2,High,Unvernalized,17,21.59,22,28,31,48,Grandprogeny,6,20
PV3_253,A,Ler2,High,Vernalized,18,18.85,23,28,32,48,Grandprogeny,5,20
PV3_254,B,Ler2,High,Vernalized,16,16.94,23,28,31,44,Grandprogeny,5,16
PV3_255,C,Ler2,High,Vernalized,13,15.96,23,28,32,48,Grandprogeny,5,20
PV3_256,D,Ler2,High,Vernalized,15,18.77,23,31,33,48,Grandprogeny,8,17
PV3_257,E,Ler2,High,Vernalized,24,31.25,27,33,36,51,Grandprogeny,6,18
PV3_258,F,Ler2,High,Vernalized,14,23.29,23,31,34,50,Grandprogeny,8,19
PV3_259,G,Ler2,High,Vernalized,17,19.73,22,28,31,48,Grandprogeny,6,20
PV3_26,B,Ag0,Low,Unvernalized,45,34.36,27,30,34,48,Grandprogeny,3,18
PV3_260,H,Ler2,High,Vernalized,13,18.03,22,28,30,44,Grandprogeny,6,16
PV3_261,I,Ler2,High,Vernalized,15,19.38,22,30,32,48,Grandprogeny,8,18
PV3_262,J,Ler2,High,Vernalized,17,26.1,23,31,34,49,Grandprogeny,8,18
PV3_263,K,Ler2,High,Vernalized,19,26.91,24,31,34,50,Grandprogeny,7,19
PV3_264,L,Ler2,High,Vernalized,17,22.87,23,29,33,49,Grandprogeny,6,20
PV3_265,A,Ler2,Low,Unvernalized,16,19.73,22,28,32,49,Grandprogeny,6,21
PV3_266,B,Ler2,Low,Unvernalized,28,35.16,27,34,37,52,Grandprogeny,7,18
PV3_267,C,Ler2,Low,Unvernalized,20,24.84,23,30,33,49,Grandprogeny,7,19
PV3_268,D,Ler2,Low,Unvernalized,21,29.97,24,29,34,48,Grandprogeny,5,19
PV3_269,E,Ler2,Low,Unvernalized,15,17.69,22,28,31,45,Grandprogeny,6,17
PV3_27,C,Ag0,Low,Unvernalized,33,38.35,27,31,34,48,Grandprogeny,4,17
PV3_270,F,Ler2,Low,Unvernalized,16,26.48,23,31,34,49,Grandprogeny,8,18
PV3_271,G,Ler2,Low,Unvernalized,25,25.28,23,31,34,50,Grandprogeny,8,19
PV3_272,H,Ler2,Low,Unvernalized,21,26.36,24,32,34,50,Grandprogeny,8,18
PV3_273,I,Ler2,Low,Unvernalized,18,23.449,23,30,32,49,Grandprogeny,7,19
PV3_274,J,Ler2,Low,Unvernalized,14,21.73,23,33,36,50,Grandprogeny,10,17
PV3_275,K,Ler2,Low,Unvernalized,17,28.41,24,30,34,48,Grandprogeny,6,18
PV3_276,L,Ler2,Low,Unvernalized,18,25.74,24,30,34,48,Grandprogeny,6,18
PV3_277,A,Ler2,Low,Vernalized,18,25.53,24,31,33,49,Grandprogeny,7,18
PV3_278,B,Ler2,Low,Vernalized,17,30.23,24,31,34,50,Grandprogeny,7,19
PV3_279,C,Ler2,Low,Vernalized,14,21.08,23,30,34,48,Grandprogeny,7,18
PV3_28,D,Ag0,Low,Unvernalized,42,33.86,27,30,34,48,Grandprogeny,3,18
PV3_280,D,Ler2,Low,Vernalized,14,19.54,22,29,32,48,Grandprogeny,7,19
PV3_281,E,Ler2,Low,Vernalized,13,12.25,23,30,34,50,Grandprogeny,7,20
PV3_282,F,Ler2,Low,Vernalized,14,23.17,23,29,33,48,Grandprogeny,6,19
PV3_283,G,Ler2,Low,Vernalized,17,26.29,24,30,33,48,Grandprogeny,6,18
PV3_284,H,Ler2,Low,Vernalized,22,29.1,24,31,34,49,Grandprogeny,7,18
PV3_285,I,Ler2,Low,Vernalized,12,18.21,23,29,32,48,Grandprogeny,6,19
PV3_286,J,Ler2,Low,Vernalized,18,22.32,24,30,33,49,Grandprogeny,6,19
PV3_287,K,Ler2,Low,Vernalized,16,20.54,22,28,32,48,Grandprogeny,6,20
PV3_288,L,Ler2,Low,Vernalized,20,22.02,23,30,34,48,Grandprogeny,7,18
PV3_289,A,Wa1,High,Unvernalized,11,14.78,17,24,27,41,Grandprogeny,7,17
PV3_29,E,Ag0,Low,Unvernalized,44,34.7,28,33,37,48,Grandprogeny,5,15
PV3_290,B,Wa1,High,Unvernalized,11,16.02,18,27,28,42,Grandprogeny,9,15
PV3_291,C,Wa1,High,Unvernalized,11,16.07,19,27,29,42,Grandprogeny,8,15
PV3_292,D,Wa1,High,Unvernalized,10,11.93,17,24,28,43,Grandprogeny,7,19
PV3_293,E,Wa1,High,Unvernalized,10,15.9,19,27,28,41,Grandprogeny,8,14
PV3_294,F,Wa1,High,Unvernalized,11,17.16,19,27,28,41,Grandprogeny,8,14
PV3_295,G,Wa1,High,Unvernalized,10,15.08,18,27,27,41,Grandprogeny,9,14
PV3_296,H,Wa1,High,Unvernalized,10,14.33,17,24,27,42,Grandprogeny,7,18
PV3_297,I,Wa1,High,Unvernalized,10,15.46,17,23,28,38,Grandprogeny,6,15
PV3_298,J,Wa1,High,Unvernalized,11,16.3,17,24,27,41,Grandprogeny,7,17
PV3_299,K,Wa1,High,Unvernalized,13,19.73,19,27,28,41,Grandprogeny,8,14
PV3_3,C,Ag0,High,Unvernalized,17,26.09,20,27,28,43,Grandprogeny,7,16
PV3_30,F,Ag0,Low,Unvernalized,36,34.07,27,32,36,48,Grandprogeny,5,16
PV3_300,L,Wa1,High,Unvernalized,11,15,17,24,27,38,Grandprogeny,7,14
PV3_301,A,Wa1,High,Vernalized,11,14.18,18,24,27,41,Grandprogeny,6,17
PV3_302,B,Wa1,High,Vernalized,10,16.12,17,24,27,41,Grandprogeny,7,17
PV3_303,C,Wa1,High,Vernalized,12,16.35,20,27,29,41,Grandprogeny,7,14
PV3_304,D,Wa1,High,Vernalized,11,17.2,20,27,29,41,Grandprogeny,7,14
PV3_305,E,Wa1,High,Vernalized,10,13.79,18,24,27,38,Grandprogeny,6,14
PV3_306,F,Wa1,High,Vernalized,13,21.93,20,27,30,42,Grandprogeny,7,15
PV3_307,G,Wa1,High,Vernalized,13,18.23,21,27,29,41,Grandprogeny,6,14
PV3_308,H,Wa1,High,Vernalized,10,12.63,17,27,28,41,Grandprogeny,10,14
PV3_309,I,Wa1,High,Vernalized,11,14.07,19,27,29,41,Grandprogeny,8,14
PV3_31,G,Ag0,Low,Unvernalized,50,33.97,27,32,34,48,Grandprogeny,5,16
PV3_310,J,Wa1,High,Vernalized,11,16.79,18,24,28,41,Grandprogeny,6,17
PV3_311,K,Wa1,High,Vernalized,11,16.64,17,23,27,41,Grandprogeny,6,18
PV3_312,L,Wa1,High,Vernalized,11,16.7,20,27,30,42,Grandprogeny,7,15
PV3_313,A,Wa1,Low,Unvernalized,10,13.22,18,27,29,41,Grandprogeny,9,14
PV3_314,B,Wa1,Low,Unvernalized,11,18.75,19,27,28,41,Grandprogeny,8,14
PV3_315,C,Wa1,Low,Unvernalized,10,15.04,17,24,27,41,Grandprogeny,7,17
PV3_316,D,Wa1,Low,Unvernalized,11,17.54,20,27,30,41,Grandprogeny,7,14
PV3_317,E,Wa1,Low,Unvernalized,11,22.96,21,27,29,41,Grandprogeny,6,14
PV3_318,F,Wa1,Low,Unvernalized,11,14.98,19,27,27,41,Grandprogeny,8,14
PV3_319,G,Wa1,Low,Unvernalized,11,15.17,19,27,28,42,Grandprogeny,8,15
PV3_32,H,Ag0,Low,Unvernalized,19,27.32,24,30,33,48,Grandprogeny,6,18
PV3_320,H,Wa1,Low,Unvernalized,10,12.33,17,23,27,41,Grandprogeny,6,18
PV3_321,I,Wa1,Low,Unvernalized,12,18.35,19,27,29,42,Grandprogeny,8,15
PV3_322,J,Wa1,Low,Unvernalized,12,18.52,19,27,30,48,Grandprogeny,8,21
PV3_323,K,Wa1,Low,Unvernalized,13,21.91,21,28,31,45,Grandprogeny,7,17
PV3_324,L,Wa1,Low,Unvernalized,11,14.98,20,28,30,49,Grandprogeny,8,21
PV3_325,A,Wa1,Low,Vernalized,11,19.07,19,27,28,42,Grandprogeny,8,15
PV3_326,B,Wa1,Low,Vernalized,12,20.3,19,27,29,45,Grandprogeny,8,18
PV3_327,C,Wa1,Low,Vernalized,12,20.79,19,27,29,44,Grandprogeny,8,17
PV3_328,D,Wa1,Low,Vernalized,12,19.93,21,28,30,45,Grandprogeny,7,17
PV3_329,E,Wa1,Low,Vernalized,11,19.78,20,27,29,44,Grandprogeny,7,17
PV3_33,I,Ag0,Low,Unvernalized,34,34.74,27,32,34,48,Grandprogeny,5,16
PV3_330,F,Wa1,Low,Vernalized,16,21.68,24,32,35,51,Grandprogeny,8,19
PV3_331,G,Wa1,Low,Vernalized,12,16.63,22,31,33,51,Grandprogeny,9,20
PV3_332,H,Wa1,Low,Vernalized,13,17.06,21,29,31,48,Grandprogeny,8,19
PV3_333,I,Wa1,Low,Vernalized,11,18.2,19,27,28,43,Grandprogeny,8,16
PV3_334,J,Wa1,Low,Vernalized,13,22.83,27,33,36,51,Grandprogeny,6,18
PV3_335,K,Wa1,Low,Vernalized,12,19.54,20,27,29,44,Grandprogeny,7,17
PV3_336,L,Wa1,Low,Vernalized,13,22.32,28,34,36,55,Grandprogeny,6,21
PV3_337,A,Ws1,High,Unvernalized,11,15.71,20,27,28,43,Grandprogeny,7,16
PV3_338,B,Ws1,High,Unvernalized,12,15.92,20,28,30,44,Grandprogeny,8,16
PV3_339,C,Ws1,High,Unvernalized,10,18.79,19,28,31,45,Grandprogeny,9,17
PV3_34,J,Ag0,Low,Unvernalized,23,29.34,22,27,30,44,Grandprogeny,5,17
PV3_340,D,Ws1,High,Unvernalized,13,18.29,20,27,30,44,Grandprogeny,7,17
PV3_341,E,Ws1,High,Unvernalized,12,15.42,20,28,31,44,Grandprogeny,8,16
PV3_342,F,Ws1,High,Unvernalized,11,19.62,19,27,27,41,Grandprogeny,8,14
PV3_343,G,Ws1,High,Unvernalized,12,14.52,20,28,30,44,Grandprogeny,8,16
PV3_344,H,Ws1,High,Unvernalized,13,17.49,20,27,29,44,Grandprogeny,7,17
PV3_345,I,Ws1,High,Unvernalized,13,18.23,20,27,30,44,Grandprogeny,7,17
PV3_346,J,Ws1,High,Unvernalized,13,17.93,20,27,30,44,Grandprogeny,7,17
PV3_347,K,Ws1,High,Unvernalized,11,15.54,19,27,29,43,Grandprogeny,8,16
PV3_348,L,Ws1,High,Unvernalized,11,14.87,20,27,30,44,Grandprogeny,7,17
PV3_349,A,Ws1,High,Vernalized,12,16.94,20,27,31,48,Grandprogeny,7,21
PV3_35,K,Ag0,Low,Unvernalized,23,25.26,23,28,31,43,Grandprogeny,5,15
PV3_350,B,Ws1,High,Vernalized,12,19.56,21,27,30,44,Grandprogeny,6,17
PV3_351,C,Ws1,High,Vernalized,11,15.7,20,28,29,48,Grandprogeny,8,20
PV3_352,D,Ws1,High,Vernalized,11,16.55,21,28,31,45,Grandprogeny,7,17
PV3_353,E,Ws1,High,Vernalized,12,17.92,20,27,28,43,Grandprogeny,7,16
PV3_354,F,Ws1,High,Vernalized,12,19.6,20,27,33,48,Grandprogeny,7,21
PV3_355,G,Ws1,High,Vernalized,12,15.72,20,27,29,43,Grandprogeny,7,16
PV3_356,H,Ws1,High,Vernalized,12,19.55,20,27,29,42,Grandprogeny,7,15
PV3_357,I,Ws1,High,Vernalized,12,15.68,18,27,29,43,Grandprogeny,9,16
PV3_358,J,Ws1,High,Vernalized,12,18.09,19,27,29,43,Grandprogeny,8,16
PV3_359,K,Ws1,High,Vernalized,13,17.59,20,27,29,43,Grandprogeny,7,16
PV3_36,L,Ag0,Low,Unvernalized,42,34.02,27,31,33,45,Grandprogeny,4,14
PV3_360,L,Ws1,High,Vernalized,13,15.67,19,27,28,42,Grandprogeny,8,15
PV3_361,A,Ws1,Low,Unvernalized,12,17.45,19,27,28,42,Grandprogeny,8,15
PV3_362,B,Ws1,Low,Unvernalized,12,16.16,18,24,27,41,Grandprogeny,6,17
PV3_363,C,Ws1,Low,Unvernalized,11,18.82,19,27,29,42,Grandprogeny,8,15
PV3_364,D,Ws1,Low,Unvernalized,13,14.78,18,27,28,41,Grandprogeny,9,14
PV3_365,E,Ws1,Low,Unvernalized,11,15.13,18,24,27,41,Grandprogeny,6,17
PV3_366,F,Ws1,Low,Unvernalized,11,15.52,17,24,28,43,Grandprogeny,7,19
PV3_367,G,Ws1,Low,Unvernalized,12,14.66,18,27,27,42,Grandprogeny,9,15
PV3_368,H,Ws1,Low,Unvernalized,12,18.12,19,27,28,42,Grandprogeny,8,15
PV3_369,I,Ws1,Low,Unvernalized,12,15.67,19,27,29,42,Grandprogeny,8,15
PV3_37,A,Ag0,Low,Vernalized,48,34.57,27,31,33,44,Grandprogeny,4,13
PV3_370,J,Ws1,Low,Unvernalized,12,16.06,18,24,28,42,Grandprogeny,6,18
PV3_371,K,Ws1,Low,Unvernalized,12,16.82,19,27,29,42,Grandprogeny,8,15
PV3_372,L,Ws1,Low,Unvernalized,12,17.81,19,27,29,42,Grandprogeny,8,15
PV3_373,A,Ws1,Low,Vernalized,12,16.22,19,27,28,41,Grandprogeny,8,14
PV3_374,B,Ws1,Low,Vernalized,13,18.42,19,27,29,41,Grandprogeny,8,14
PV3_375,C,Ws1,Low,Vernalized,11,12.4,18,24,27,41,Grandprogeny,6,17
PV3_376,D,Ws1,Low,Vernalized,13,17.57,20,27,29,41,Grandprogeny,7,14
PV3_377,E,Ws1,Low,Vernalized,13,19.87,20,27,28,42,Grandprogeny,7,15
PV3_378,F,Ws1,Low,Vernalized,13,19.74,19,27,28,42,Grandprogeny,8,15
PV3_379,G,Ws1,Low,Vernalized,12,15.64,17,24,27,42,Grandprogeny,7,18
PV3_38,B,Ag0,Low,Vernalized,19,23.58,20,27,28,44,Grandprogeny,7,17
PV3_380,H,Ws1,Low,Vernalized,14,17.47,20,27,28,42,Grandprogeny,7,15
PV3_381,I,Ws1,Low,Vernalized,12,17.39,19,27,28,41,Grandprogeny,8,14
PV3_382,J,Ws1,Low,Vernalized,11,14.98,18,24,27,41,Grandprogeny,6,17
PV3_383,K,Ws1,Low,Vernalized,12,16.55,19,27,28,41,Grandprogeny,8,14
PV3_384,L,Ws1,Low,Vernalized,12,16.25,19,27,28,41,Grandprogeny,8,14
PV3_39,C,Ag0,Low,Vernalized,26,25.16,21,27,28,43,Grandprogeny,6,16
PV3_4,D,Ag0,High,Unvernalized,17,27.16,23,29,31,44,Grandprogeny,6,15
PV3_40,D,Ag0,Low,Vernalized,16,23.21,20,27,28,44,Grandprogeny,7,17
PV3_41,E,Ag0,Low,Vernalized,17,24.78,20,27,32,44,Grandprogeny,7,17
PV3_42,F,Ag0,Low,Vernalized,19,23.11,20,27,28,44,Grandprogeny,7,17
PV3_44,H,Ag0,Low,Vernalized,24,25.88,21,27,28,43,Grandprogeny,6,16
PV3_45,I,Ag0,Low,Vernalized,24,29.35,22,27,29,43,Grandprogeny,5,16
PV3_46,J,Ag0,Low,Vernalized,16,25.17,21,27,30,43,Grandprogeny,6,16
PV3_47,K,Ag0,Low,Vernalized,20,25.34,22,28,30,43,Grandprogeny,6,15
PV3_48,L,Ag0,Low,Vernalized,13,21.75,20,27,29,43,Grandprogeny,7,16
PV3_49,A,Col0,High,Unvernalized,31,34.1,31,36,40,55,Grandprogeny,5,19
PV3_5,E,Ag0,High,Unvernalized,17,23.36,20,27,32,44,Grandprogeny,7,17
PV3_50,B,Col0,High,Unvernalized,26,30.02,28,32,35,48,Grandprogeny,4,16
PV3_51,C,Col0,High,Unvernalized,25,32.94,28,33,35,49,Grandprogeny,5,16
PV3_52,D,Col0,High,Unvernalized,27,29.14,31,34,37,49,Grandprogeny,3,15
PV3_53,E,Col0,High,Unvernalized,29,30.09,31,36,38,51,Grandprogeny,5,15
PV3_54,F,Col0,High,Unvernalized,28,28.84,28,32,34,48,Grandprogeny,4,16
PV3_55,G,Col0,High,Unvernalized,30,37.11,28,31,36,48,Grandprogeny,3,17
PV3_56,H,Col0,High,Unvernalized,24,34.84,29,34,37,50,Grandprogeny,5,16
PV3_57,I,Col0,High,Unvernalized,25,27.12,29,34,36,49,Grandprogeny,5,15
PV3_58,J,Col0,High,Unvernalized,26,32.87,28,32,36,49,Grandprogeny,4,17
PV3_59,K,Col0,High,Unvernalized,24,29.17,28,32,35,48,Grandprogeny,4,16
PV3_6,F,Ag0,High,Unvernalized,32,39.01,29,33,35,48,Grandprogeny,4,15
PV3_60,L,Col0,High,Unvernalized,23,30.39,31,35,39,51,Grandprogeny,4,16
PV3_61,A,Col0,High,Vernalized,24,22.06,31,35,38,51,Grandprogeny,4,16
PV3_62,B,Col0,High,Vernalized,20,21.69,28,31,33,48,Grandprogeny,3,17
PV3_63,C,Col0,High,Vernalized,25,24.6,33,38,42,56,Grandprogeny,5,18
PV3_64,D,Col0,High,Vernalized,26,27.95,29,33,37,50,Grandprogeny,4,17
PV3_65,E,Col0,High,Vernalized,31,31.55,28,33,36,51,Grandprogeny,5,18
PV3_66,F,Col0,High,Vernalized,36,37.45,29,34,38,51,Grandprogeny,5,17
PV3_67,G,Col0,High,Vernalized,40,35.44,35,39,43,58,Grandprogeny,4,19
PV3_68,H,Col0,High,Vernalized,34,34.83,32,36,40,51,Grandprogeny,4,15
PV3_69,I,Col0,High,Vernalized,32,35.72,28,33,36,51,Grandprogeny,5,18
PV3_7,G,Ag0,High,Unvernalized,20,27.52,23,28,32,44,Grandprogeny,5,16
PV3_70,J,Col0,High,Vernalized,34,40.19,28,33,36,51,Grandprogeny,5,18
PV3_71,K,Col0,High,Vernalized,35,35.12,30,35,38,51,Grandprogeny,5,16
PV3_72,L,Col0,High,Vernalized,35,37.11,29,35,38,55,Grandprogeny,6,20
PV3_73,A,Col0,Low,Unvernalized,54,37.5,35,40,43,61,Grandprogeny,5,21
PV3_74,B,Col0,Low,Unvernalized,34,33.39,29,34,38,51,Grandprogeny,5,17
PV3_75,C,Col0,Low,Unvernalized,30,40.34,31,35,39,55,Grandprogeny,4,20
PV3_76,D,Col0,Low,Unvernalized,39,38.47,30,35,38,51,Grandprogeny,5,16
PV3_77,E,Col0,Low,Unvernalized,36,38.38,33,38,42,57,Grandprogeny,5,19
PV3_78,F,Col0,Low,Unvernalized,31,34.81,28,34,38,51,Grandprogeny,6,17
PV3_79,G,Col0,Low,Unvernalized,37,38.26,36,42,45,58,Grandprogeny,6,16
PV3_8,H,Ag0,High,Unvernalized,37,36.86,29,34,36,51,Grandprogeny,5,17
PV3_80,H,Col0,Low,Unvernalized,38,45.97,39,48,50,65,Grandprogeny,9,17
PV3_81,I,Col0,Low,Unvernalized,35,39.87,28,33,37,51,Grandprogeny,5,18
PV3_82,J,Col0,Low,Unvernalized,29,37.8,28,34,36,51,Grandprogeny,6,17
PV3_83,K,Col0,Low,Unvernalized,28,38.23,28,33,37,51,Grandprogeny,5,18
PV3_84,L,Col0,Low,Unvernalized,36,41.95,30,35,38,52,Grandprogeny,5,17
PV3_85,A,Col0,Low,Vernalized,34,37.98,32,38,42,55,Grandprogeny,6,17
PV3_86,B,Col0,Low,Vernalized,34,33.64,30,35,38,51,Grandprogeny,5,16
PV3_89,E,Col0,Low,Vernalized,43,39.85,28,33,37,51,Grandprogeny,5,18
PV3_9,I,Ag0,High,Unvernalized,45,,27,33,35,48,Grandprogeny,6,15
PV3_90,F,Col0,Low,Vernalized,33,33.74,29,33,37,50,Grandprogeny,4,17
PV3_91,G,Col0,Low,Vernalized,32,37.22,28,33,36,51,Grandprogeny,5,18
PV3_92,H,Col0,Low,Vernalized,37,38.62,30,34,38,51,Grandprogeny,4,17
PV3_93,I,Col0,Low,Vernalized,58,34.17,44,48,51,68,Grandprogeny,4,20
PV3_94,J,Col0,Low,Vernalized,40,38.23,33,37,41,55,Grandprogeny,4,18
PV3_95,K,Col0,Low,Vernalized,44,42.51,36,41,44,60,Grandprogeny,5,19
PV3_96,L,Col0,Low,Vernalized,35,40.14,33,39,42,56,Grandprogeny,6,17
PV3_97,A,Cvi0,High,Unvernalized,21,44.39,33,39,43,56,Grandprogeny,6,17
PV3_98,B,Cvi0,High,Unvernalized,38,43.56,33,36,40,55,Grandprogeny,3,19
PV3_99,C,Cvi0,High,Unvernalized,22,42.78,32,39,41,60,Grandprogeny,7,21
